00000000000000000000
00000000000000000000
00000000000000000000
00000000000000000000
00000000000000000000
00000000000000000000
00000111111111110000
00000100000000010000
00000100000000010000
00000100100010010000
00000101000001010000
00000101010101010000
00000100011100010000
00000100000000010000
00000111111111110000
00000000000000000000
00000000000000000000
00000000000000000000
00000000000000000000
00000000000000000000
